0 4 6 6 6 6 6 6 6 6 8 0 7 4 4 8 0 0 7 4
4 3 5 5 5 5 5 5 5 5 8 0 7 4 4 8 0 0 9 4
4 3 1 1 1 1 1 1 1 1 8 0 7 4 4 8 0 0 7 4
4 3 0 0 0 0 0 0 0 7 8 0 7 4 4 8 0 0 9 4
4 3 0 0 0 0 0 0 0 0 0 0 7 6 6 8 0 0 7 4
4 3 0 0 0 0 0 0 0 7 8 0 0 2 2 2 2 2 9 4
4 3 0 0 0 0 0 0 0 7 8 0 7 6 6 6 6 4 4 4
4 3 0 0 0 0 0 0 0 7 8 0 0 0 0 0 0 9 4 4
4 3 0 0 0 0 0 0 0 7 8 0 0 0 0 0 0 9 4 4
4 3 0 0 0 0 0 0 0 7 8 0 0 0 0 0 0 9 4 4
4 2 0 0 0 0 0 0 0 7 8 0 0 0 0 0 0 9 4 4
4 4 10 10 10 10 10 10 10 10 3 3 3 3 3 3 3 9 4 4