5 5 3 3 3 3 3 3 3 3 6 0 7 5 6 0 0 0 7 5
5 4 1 1 1 1 1 1 1 1 6 0 7 5 6 0 0 0 9 5
5 4 10 10 10 10 10 10 10 10 6 0 7 5 6 0 0 0 7 5
5 4 0 0 0 0 0 0 0 7 6 0 7 3 6 0 0 0 9 5
5 4 0 0 0 0 0 0 0 0 0 0 0 0 8 8 8 8 7 5
5 4 0 0 0 0 0 0 0 7 6 0 0 7 3 3 3 5 5 5
5 4 0 0 0 0 0 0 0 7 6 0 0 0 0 0 0 9 5 5
5 4 0 0 0 0 0 0 0 7 6 0 0 0 0 0 0 9 5 5
5 4 0 0 0 0 0 0 0 7 6 0 0 0 0 0 0 9 5 5
5 4 0 0 0 0 0 0 0 7 6 0 0 0 0 0 0 9 5 5
5 4 0 0 0 0 0 0 0 7 6 0 0 0 0 0 0 9 5 5
5 5 2 2 2 2 2 2 2 2 6 0 0 0 0 0 0 9 4 4