0 0 6 6 6 6 6 6 6 6 8 3 7 0 0 8 3 3 7 0
0 2 5 5 5 5 5 5 5 5 8 3 7 0 0 8 3 3 9 0
0 2 1 1 1 1 1 1 1 1 8 3 7 0 0 8 3 3 7 0
0 2 3 3 3 3 3 3 3 7 8 3 7 0 0 8 3 3 9 0
0 2 3 3 3 3 3 3 3 3 3 3 7 6 6 8 3 3 7 0
0 2 3 3 3 3 3 3 3 7 8 3 3 10 10 10 10 10 9 0
0 2 3 3 3 3 3 3 3 7 8 3 7 6 6 6 6 0 0 0
0 2 3 3 3 3 3 3 3 7 8 3 3 3 3 3 3 9 0 0
0 2 3 3 3 3 3 3 3 7 8 3 3 3 3 3 3 9 0 0
0 2 3 3 3 3 3 3 3 7 8 3 3 3 3 3 3 9 0 0
0 2 3 3 3 3 3 3 3 7 8 3 3 3 3 3 3 9 0 0
0 0 4 4 4 4 4 4 4 4 3 3 3 3 3 3 3 9 0 0